date,0,1,Bexar,2,3,El Paso,Lubbock,Webb,,,Texas
3/26/20,2,10,3,1,0,0,0,0,16,5,21
3/27/20,3,10,5,2,0,0,0,0,20,5,25
3/28/20,4,13,5,2,0,0,0,0,24,6,30
3/29/20,5,13,5,3,0,0,0,0,26,9,35
3/30/20,8,16,5,4,0,0,1,1,35,11,46
3/31/20,9,19,9,4,0,0,1,2,44,13,57
4/1/20,11,23,9,4,0,0,2,2,51,14,65
4/2/20,15,29,9,5,0,0,3,3,64,16,80
4/3/20,18,32,10,5,0,0,3,5,73,25,98
4/4/20,27,36,11,8,0,0,4,5,91,33,124
4/5/20,30,39,11,9,0,0,4,6,99,37,136
4/6/20,33,42,12,11,0,0,6,6,110,49,159
4/7/20,38,48,18,11,1,0,6,6,128,49,177
4/8/20,48,51,18,13,1,0,6,6,143,52,195
4/9/20,54,57,22,14,4,1,7,6,165,63,228
4/10/20,64,61,24,14,4,2,9,6,184,65,249
4/11/20,66,65,24,16,4,2,13,6,196,69,265
4/12/20,70,76,27,16,4,2,14,6,215,73,288
4/13/20,75,80,27,18,4,2,21,8,235,85,320
4/14/20,86,95,33,21,4,4,25,8,276,89,365
4/15/20,95,97,37,21,4,4,25,10,293,102,395
4/16/20,102,109,37,24,6,7,25,11,321,107,428
4/17/20,108,117,37,28,8,7,28,11,344,117,461
4/18/20,113,127,38,30,9,8,28,11,364,123,487
4/19/20,119,128,39,32,9,8,32,11,378,125,503
4/20/20,125,129,39,33,10,9,36,11,392,131,523
4/21/20,127,138,39,35,11,9,38,11,408,144,552
4/22/20,129,142,39,36,13,10,39,12,420,151,571
4/23/20,134,150,43,39,17,10,40,12,445,156,601
4/24/20,138,160,43,40,19,10,40,12,462,163,625
4/25/20,144,169,43,45,20,12,40,13,486,176,662
4/26/20,148,172,43,48,21,12,40,15,499,177,676
4/27/20,159,174,44,51,21,12,43,15,519,180,699
4/28/20,169,191,44,52,23,14,43,15,551,187,738
4/29/20,175,199,46,55,25,18,43,16,577,199,776
4/30/20,184,213,48,59,26,21,45,16,612,216,828
5/1/20,195,219,48,64,27,22,43,16,634,219,853
5/2/20,204,225,48,64,27,22,44,16,650,225,875
5/3/20,209,230,48,65,27,22,44,16,661,229,890
5/4/20,218,235,48,66,27,22,45,17,678,236,914
5/5/20,224,248,52,72,28,22,46,17,709,246,955
5/6/20,232,255,53,73,29,23,47,17,729,256,985
5/7/20,238,262,54,74,30,30,48,17,753,263,1016
5/8/20,248,282,56,75,30,32,49,17,789,270,1059
5/9/20,258,296,56,76,33,32,49,17,817,269,1086
5/10/20,264,299,56,76,33,33,49,17,827,283,1110
5/11/20,272,303,57,82,34,33,50,17,848,289,1137
5/12/20,278,311,57,90,34,33,50,17,870,299,1169
5/13/20,283,322,58,91,38,41,50,17,900,305,1205
5/14/20,290,334,59,96,39,43,50,17,928,328,1256
5/15/20,290,343,62,99,39,45,50,17,945,355,1300
5/16/20,303,350,62,99,39,46,50,18,967,363,1330
5/17/20,304,358,62,99,40,47,50,18,978,378,1356
5/18/20,305,359,62,101,40,47,50,18,982,380,1362
5/19/20,307,380,62,104,43,52,50,18,1016,389,1405
5/20/20,313,387,63,105,45,54,50,18,1035,408,1443
5/21/20,320,402,64,106,45,57,50,18,1062,418,1480
5/22/20,324,411,66,107,45,58,50,18,1079,419,1498
5/23/20,327,416,66,107,45,58,50,18,1087,435,1522
5/24/20,328,418,69,108,46,58,50,18,1095,438,1533
5/25/20,328,418,69,110,46,58,50,19,1098,438,1536
5/26/20,330,420,69,113,46,60,50,19,1107,445,1552
5/27/20,334,439,70,116,46,68,50,19,1142,456,1598
5/28/20,335,443,71,118,46,72,50,19,1154,464,1618
5/29/20,339,447,72,120,48,77,50,19,1172,473,1645
5/30/20,350,458,73,121,49,78,50,19,1198,478,1676
5/31/20,351,459,74,121,49,78,50,19,1201,482,1683
6/1/20,354,461,75,122,50,80,50,19,1211,484,1695
6/2/20,356,479,75,122,50,83,50,19,1234,498,1732
6/3/20,363,484,78,125,50,88,50,19,1257,509,1766
6/4/20,371,490,78,127,53,89,50,19,1277,516,1793
6/5/20,379,502,78,129,53,90,50,19,1300,521,1821
6/6/20,385,506,78,130,53,90,50,19,1311,529,1840
6/7/20,388,510,78,130,54,90,50,19,1319,527,1846
6/8/20,391,513,78,131,54,91,50,19,1327,529,1856
6/9/20,392,527,80,134,54,93,50,20,1350,536,1886
6/10/20,400,536,80,134,55,93,50,20,1368,548,1916
6/11/20,400,540,82,137,57,97,50,20,1383,559,1942
6/12/20,406,544,84,140,59,98,51,20,1402,563,1965
6/13/20,412,550,88,140,59,100,51,20,1420,569,1989
6/14/20,413,554,88,140,59,100,51,20,1425,570,1995
6/15/20,424,556,89,143,63,102,51,20,1448,570,2018
6/16/20,430,565,89,143,65,109,51,20,1472,585,2057
6/17/20,439,575,90,149,68,113,51,21,1506,593,2099
6/18/20,446,586,92,149,72,119,51,22,1537,600,2137
6/19/20,453,592,96,150,75,119,51,22,1558,610,2168
6/20/20,465,595,96,151,75,120,51,22,1575,611,2186
6/21/20,468,596,97,152,76,120,51,22,1582,613,2195
6/22/20,475,601,97,154,77,120,51,22,1597,616,2213
6/23/20,478,609,100,157,78,122,51,22,1617,629,2246
6/24/20,492,619,104,159,85,122,51,23,1655,637,2292
6/25/20,499,629,104,160,87,125,51,23,1678,643,2321
6/26/20,509,644,105,163,89,126,51,23,1710,652,2362
6/27/20,519,654,107,164,92,127,51,23,1737,661,2398
6/28/20,521,656,109,164,94,127,51,24,1746,662,2408
6/29/20,526,657,109,171,98,128,51,25,1765,665,2430
6/30/20,529,680,110,176,109,130,51,25,1810,672,2482
7/1/20,535,691,111,180,110,131,52,26,1836,682,2518
7/2/20,547,702,115,185,114,132,52,27,1874,688,2562
7/3/20,556,708,117,189,130,135,52,27,1914,695,2609
7/4/20,561,711,122,191,136,135,52,28,1936,710,2646
7/5/20,561,714,130,192,139,135,52,28,1951,715,2666
7/6/20,563,723,132,202,160,135,56,29,2000,726,2726
7/7/20,576,745,137,210,185,139,56,32,2080,736,2816
7/8/20,582,770,146,220,209,144,58,36,2165,770,2935
7/9/20,598,789,165,223,231,145,59,39,2249,788,3037
7/10/20,615,802,166,231,261,150,60,40,2325,804,3129
7/11/20,637,813,175,234,271,150,60,43,2383,823,3206
7/12/20,641,819,184,237,283,151,60,43,2418,828,3246
7/13/20,653,827,195,242,289,152,63,46,2467,846,3313
7/14/20,664,851,201,249,326,157,63,49,2560,889,3449
7/15/20,689,865,208,259,367,159,64,51,2662,928,3590
7/16/20,710,889,229,269,404,173,65,55,2794,950,3744
7/17/20,731,908,240,280,438,177,65,59,2898,991,3889
7/18/20,739,922,251,290,453,179,65,62,2961,1011,3972
7/19/20,750,929,257,292,475,179,65,65,3012,1021,4033
7/20/20,765,935,262,301,532,184,66,66,3111,1049,4160
7/21/20,785,952,274,313,601,187,67,71,3250,1069,4319
7/22/20,804,995,283,319,653,196,68,77,3395,1127,4522
7/23/20,838,1016,298,336,710,211,68,90,3567,1147,4714
7/24/20,860,1035,313,349,754,218,68,97,3694,1182,4876
7/25/20,885,1071,322,351,770,221,68,99,3787,1215,5002
7/26/20,894,1076,323,353,774,224,68,104,3816,1274,5090
7/27/20,1417,1097,480,376,887,230,72,114,4673,1619,6292
7/28/20,1455,1122,497,381,961,239,75,118,4848,1670,6518
7/29/20,1534,1167,521,371,1032,252,75,121,5073,1761,6834
7/30/20,1565,1177,545,374,1086,259,75,122,5203,1784,6987
7/31/20,1631,1208,578,383,1145,266,78,127,5416,1857,7273
8/1/20,1674,1226,611,386,1172,269,78,128,5544,1933,7477
8/2/20,1674,1238,611,389,1197,273,78,128,5588,1932,7520
8/3/20,1713,1242,622,397,1254,276,78,136,5718,1979,7697
8/4/20,1770,1285,646,400,1322,278,79,140,5920,2031,7951
8/5/20,1826,1304,673,403,1354,280,80,144,6064,2088,8152
8/6/20,1884,1330,705,407,1397,285,80,149,6237,2163,8400
8/7/20,1953,1361,739,421,1434,286,80,155,6429,2251,8680
8/8/20,2010,1378,773,426,1449,291,80,163,6570,2315,8885
8/9/20,2028,1384,782,429,1473,293,80,169,6638,2346,8984
8/10/20,2041,1389,784,435,1502,300,81,174,6706,2358,9064
8/11/20,2084,1433,806,441,1552,307,83,175,6881,2430,9311
8/12/20,2163,1458,826,455,1625,310,84,179,7100,2545,9645
8/13/20,2213,1480,850,473,1657,330,85,184,7272,2607,9879
8/14/20,2284,1513,865,481,1736,354,87,185,7505,2690,10195
8/15/20,2339,1530,887,486,1757,357,87,191,7634,2745,10379
8/16/20,2362,1538,892,487,1802,358,87,193,7719,2779,10498
8/17/20,2371,1545,892,487,1810,361,87,202,7755,2804,10559
8/18/20,2416,1568,913,492,1883,366,89,207,7934,2864,10798
8/19/20,2473,1591,935,507,1921,372,90,212,8101,2942,11043
8/20/20,2517,1606,957,510,1962,382,92,215,8241,3007,11248
8/21/20,2551,1638,981,518,2006,387,92,218,8391,3092,11483
8/22/20,2592,1658,992,525,2025,392,93,219,8496,3154,11650
8/23/20,2613,1668,998,525,2057,392,93,223,8569,3191,11760
8/24/20,2615,1676,998,531,2074,394,94,227,8609,3215,11824
8/25/20,2669,1693,1007,539,2116,397,94,229,8744,3268,12012
8/26/20,2714,1726,1026,546,2154,399,95,232,8892,3320,12212
8/27/20,2756,1749,1046,554,2196,410,97,236,9044,3400,12444
8/28/20,2775,1775,1062,559,2235,423,98,242,9169,3446,12615
8/29/20,2802,1791,1078,566,2250,428,98,242,9255,3478,12733
8/30/20,2820,1799,1086,567,2266,428,98,243,9307,3500,12807
8/31/20,2829,1800,1086,573,2281,428,100,244,9341,3516,12857
9/1/20,2850,1819,1101,574,2315,433,101,244,9437,3567,13004
9/2/20,2898,1841,1119,579,2351,439,102,244,9573,3612,13185
9/3/20,2942,1857,1136,580,2394,446,102,247,9704,3683,13387
9/4/20,2964,1871,1145,588,2426,449,104,250,9797,3719,13516
9/5/20,2997,1891,1159,591,2435,459,104,250,9886,3774,13660
9/6/20,3005,1900,1165,594,2459,464,105,252,9944,3795,13739
9/7/20,3006,1902,1166,595,2486,464,105,255,9979,3802,13781
9/8/20,3017,1904,1167,600,2511,464,105,259,10027,3828,13855
9/9/20,3050,1922,1172,600,2540,465,105,260,10114,3872,13986
9/10/20,3050,1922,1172,604,2541,465,105,261,10120,3878,13998
9/11/20,3100,1956,1191,609,2605,470,107,266,10304,3975,14279
9/12/20,3129,1966,1200,612,2607,479,108,267,10368,4016,14384
9/13/20,3138,1972,1204,612,2642,481,108,268,10425,4033,14458
9/14/20,3142,1974,1205,617,2664,482,109,272,10465,4043,14508
9/15/20,3161,1989,1215,623,2695,484,113,273,10553,4108,14661
9/16/20,3189,2008,1228,627,2724,488,113,275,10652,4151,14803
9/17/20,3205,2018,1233,630,2750,490,116,280,10722,4187,14909
9/18/20,3223,2041,1242,632,2780,491,117,281,10807,4230,15037
9/19/20,3243,2058,1244,635,2782,497,117,281,10857,4267,15124
9/20/20,3250,2064,1246,635,2785,504,119,282,10885,4274,15159
9/21/20,3251,2064,1248,636,2822,505,119,284,10929,4283,15212
9/22/20,3266,2072,1255,639,2856,508,120,288,11004,4318,15322
9/23/20,3288,2096,1264,643,2890,510,121,289,11101,4354,15455
9/24/20,3306,2109,1271,644,2916,518,122,289,11175,4412,15587
9/25/20,3306,2109,1271,647,2954,518,124,290,11219,4418,15637
9/26/20,3340,2127,1297,649,2954,521,125,290,11303,4489,15792
9/27/20,3347,2132,1297,653,2955,522,125,292,11323,4508,15831
9/28/20,3347,2133,1297,654,3003,523,125,295,11377,4521,15898
9/29/20,3359,2143,1303,655,3033,523,129,297,11442,4552,15994
9/30/20,3374,2154,1313,657,3059,526,129,297,11509,4593,16102
10/1/20,3388,2165,1318,660,3088,528,129,302,11578,4642,16220
10/2/20,3397,2172,1323,662,3112,531,131,305,11633,4674,16307
10/3/20,3409,2186,1329,662,3182,531,131,305,11735,4705,16440
10/4/20,3416,2191,1332,662,3182,534,131,310,11758,4713,16471
10/5/20,3419,2192,1332,663,3214,536,132,315,11803,4716,16519
10/6/20,3425,2206,1336,668,3239,538,134,321,11867,4755,16622
10/7/20,3442,2221,1339,672,3265,543,135,326,11943,4804,16747
10/8/20,3452,2231,1347,674,3289,546,137,328,12004,4849,16853
10/9/20,3465,2242,1356,678,3308,549,137,329,12064,4891,16955
10/10/20,3473,2252,1360,679,3310,555,138,329,12096,4923,17019
10/11/20,3481,2255,1360,680,3311,556,139,329,12111,4936,17047
10/12/20,3481,2256,1360,681,3327,556,139,331,12131,4942,17073
10/13/20,3492,2264,1361,682,3352,558,149,333,12191,4974,17165
10/14/20,3509,2278,1366,683,3374,560,152,336,12258,5018,17276
10/15/20,3521,2286,1370,684,3387,564,152,337,12301,5061,17362
10/16/20,3533,2296,1376,687,3393,571,156,337,12349,5105,17454
10/17/20,3543,2305,1379,691,3396,575,156,337,12382,5136,17518
10/18/20,3546,2313,1381,691,3397,575,157,337,12397,5144,17541
10/19/20,3547,2314,1381,692,3400,575,157,343,12409,5155,17564
10/20/20,3556,2325,1383,695,3407,576,165,345,12452,5192,17644
10/21/20,3572,2340,1385,695,3409,579,168,348,12496,5247,17743
10/22/20,3572,2340,1385,695,3412,579,173,348,12504,5256,17760
10/23/20,3585,2352,1386,696,3436,581,174,349,12559,5315,17874
10/24/20,3605,2374,1392,700,3437,593,174,349,12624,5374,17998
10/25/20,3613,2379,1394,701,3437,595,175,352,12646,5396,18042
10/26/20,3614,2382,1394,701,3443,595,184,353,12666,5411,18077
10/27/20,3622,2394,1402,702,3457,596,188,355,12716,5439,18155
10/28/20,3631,2410,1407,703,3463,601,195,355,12765,5486,18251
10/29/20,3641,2424,1409,705,3472,612,202,356,12821,5551,18372
10/30/20,3651,2444,1410,707,3477,623,206,356,12874,5603,18477
10/31/20,3654,2465,1412,708,3478,633,208,356,12914,5635,18549
11/1/20,3657,2469,1414,708,3478,642,208,356,12932,5650,18582
11/2/20,3662,2471,1414,710,3489,644,214,357,12961,5665,18626
11/3/20,3672,2487,1415,713,3495,649,222,358,13011,5711,18722
11/4/20,3692,2501,1422,715,3506,669,230,361,13096,5774,18870
11/5/20,3704,2529,1424,718,3509,676,234,361,13155,5845,19000
11/6/20,3713,2557,1425,719,3522,683,237,361,13217,5908,19125
11/7/20,3725,2575,1427,720,3522,691,243,361,13264,5955,19219
11/8/20,3727,2581,1429,720,3522,697,243,363,13282,5974,19256
11/9/20,3730,2584,1429,720,3527,708,248,366,13312,5986,19298
11/10/20,3737,2601,1433,724,3539,717,253,367,13371,6052,19423
11/11/20,3743,2628,1438,725,3544,729,257,368,13432,6112,19544
11/12/20,3756,2649,1444,729,3548,751,264,371,13512,6193,19705
11/13/20,3767,2679,1447,731,3554,778,269,373,13598,6319,19917
11/14/20,3785,2705,1449,734,3554,792,272,374,13665,6370,20035
11/15/20,3788,2720,1451,735,3561,803,273,375,13706,6404,20110
11/16/20,3790,2725,1451,735,3570,807,277,379,13734,6423,20157
11/17/20,3804,2752,1453,740,3575,818,282,385,13809,6469,20278
11/18/20,3817,2790,1458,740,3587,839,286,385,13902,6569,20471
11/19/20,3838,2825,1465,746,3597,876,292,385,14024,6665,20689
11/20/20,3851,2861,1468,750,3608,910,296,386,14130,6742,20872
11/21/20,3863,2883,1473,751,3608,949,300,387,14214,6790,21004
11/22/20,3867,2892,1476,752,3609,973,303,388,14260,6823,21083
11/23/20,3869,2896,1476,752,3612,980,307,389,14281,6863,21144
11/24/20,3885,2922,1480,753,3631,995,325,394,14385,6953,21338
11/25/20,3899,2958,1486,760,3637,1013,334,396,14483,7053,21536
11/26/20,3914,2986,1489,763,3637,1048,340,397,14574,7135,21709
11/27/20,3918,3004,1492,763,3645,1055,345,397,14619,7143,21762
11/28/20,3925,3020,1494,764,3645,1068,351,398,14665,7182,21847
11/29/20,3933,3030,1496,765,3652,1074,355,398,14703,7197,21900
11/30/20,3934,3033,1498,766,3660,1078,359,398,14726,7242,21968
12/1/20,3943,3069,1502,769,3677,1091,364,411,14826,7378,22204
12/2/20,3960,3105,1512,777,3692,1107,371,411,14935,7487,22422
12/3/20,3977,3145,1516,786,3707,1142,381,417,15071,7574,22645
12/4/20,3995,3189,1525,792,3720,1186,394,417,15218,7672,22890
12/5/20,4014,3233,1536,794,3721,1220,400,418,15336,7775,23111
12/6/20,4023,3246,1537,795,3723,1233,402,419,15378,7809,23187
12/7/20,4026,3252,1538,796,3728,1241,402,420,15403,7855,23258
12/8/20,4046,3286,1544,800,3738,1249,410,420,15493,7946,23439
12/9/20,4072,3325,1552,811,3756,1282,427,431,15656,8071,23727
12/10/20,4083,3379,1561,817,3760,1302,436,438,15776,8191,23967
12/11/20,4108,3408,1568,825,3777,1317,446,441,15890,8318,24208
12/12/20,4128,3450,1574,826,3777,1350,457,441,16003,8397,24400
12/13/20,4141,3472,1577,827,3779,1374,459,443,16072,8429,24501
12/14/20,4141,3474,1577,829,3794,1382,465,452,16114,8468,24582
12/15/20,4160,3504,1582,830,3804,1394,474,458,16206,8590,24796
12/16/20,4180,3553,1591,839,3819,1418,485,462,16347,8731,25078
12/17/20,4214,3602,1600,844,3825,1437,495,466,16483,8853,25336
12/18/20,4238,3668,1609,850,3831,1466,501,468,16631,8977,25608
12/19/20,4261,3703,1629,858,3833,1498,505,468,16755,9086,25841
12/20/20,4273,3726,1630,859,3837,1513,508,473,16819,9129,25948
12/21/20,4277,3828,1631,866,3845,1530,514,473,16964,9200,26164
12/22/20,4301,3871,1642,875,3859,1547,520,480,17095,9268,26363
12/23/20,4332,3912,1652,880,3870,1567,523,480,17216,9408,26624
12/24/20,4368,3952,1666,884,3883,1598,523,485,17359,9520,26879
12/25/20,4400,3980,1684,886,3885,1609,523,485,17452,9590,27042
12/26/20,4400,3984,1685,891,3890,1610,524,485,17469,9593,27062
12/27/20,4403,3991,1689,893,3890,1611,531,491,17499,9611,27110
12/28/20,4407,4033,1689,905,3896,1616,538,496,17580,9665,27245
12/29/20,4434,4094,1699,912,3904,1622,543,496,17704,9795,27499
12/30/20,4465,4148,1709,917,3919,1645,552,505,17860,9961,27821
12/31/20,4507,4219,1726,926,3931,1666,561,505,18041,10114,28155
1/1/21,4535,4252,1739,930,3935,1700,571,509,18171,10263,28434
1/2/21,4545,4266,1743,934,3935,1702,573,509,18207,10301,28508
1/3/21,4553,4275,1745,935,3941,1703,573,509,18234,10320,28554
1/4/21,4562,4335,1747,939,3952,1708,576,509,18328,10353,28681
1/5/21,4585,4377,1758,952,3972,1714,584,516,18458,10491,28949
1/6/21,4626,4432,1778,963,3991,1731,592,523,18636,10642,29278
1/7/21,4678,4496,1799,967,4009,1760,597,523,18829,10816,29645
1/8/21,4712,4674,1827,986,4023,1778,602,526,19128,10981,30109
1/9/21,4758,4727,1844,995,4032,1819,606,526,19307,11134,30441
1/10/21,4770,4757,1859,1001,4035,1836,611,526,19395,11204,30599
1/11/21,4777,4789,1862,1001,4051,1853,615,528,19476,11244,30720
1/12/21,4820,4860,1884,1007,4058,1860,618,528,19635,11382,31017
1/13/21,4873,4928,1912,1022,4082,1869,622,528,19836,11560,31396
1/14/21,4926,4987,1942,1046,4105,1896,626,543,20071,11748,31819
1/15/21,4978,5067,1970,1064,4116,1909,634,543,20281,11931,32212
1/16/21,5054,5115,2008,1078,4123,1929,640,563,20510,12071,32581
1/17/21,5072,5155,2019,1085,4126,1935,640,563,20595,12152,32747
1/18/21,5076,5230,2020,1089,4126,1936,641,563,20681,12177,32858
1/19/21,5118,5279,2040,1109,4152,1940,648,565,20851,12325,33176
1/20/21,5175,5364,2067,1135,4185,1964,653,569,21112,12520,33632
1/21/21,5221,5455,2090,1152,4216,1989,656,569,21348,12727,34075
1/22/21,5281,5548,2123,1168,4240,2016,661,569,21606,12890,34496
1/23/21,5336,5596,2144,1196,4246,2031,665,592,21806,13053,34859
1/24/21,5382,5617,2153,1205,4252,2048,671,592,21920,13130,35050
1/25/21,5393,5710,2161,1207,4280,2064,671,592,22078,13158,35236
1/26/21,5444,5760,2181,1225,4292,2068,675,609,22254,13290,35544
1/27/21,5517,5872,2216,1246,4328,2071,680,609,22539,13485,36024
1/28/21,5578,5930,2262,1263,4371,2086,684,609,22783,13651,36434
1/29/21,5636,6003,2303,1288,4385,2095,687,628,23025,13779,36804
1/30/21,5695,6050,2329,1302,4397,2102,690,631,23196,13900,37096
1/31/21,5718,6074,2348,1313,4399,2116,692,631,23291,13951,37242
2/1/21,5727,6163,2349,1320,4428,2117,693,632,23429,13976,37405
2/2/21,5792,6238,2380,1332,4442,2126,697,632,23639,14121,37760
2/3/21,5857,6306,2416,1359,4478,2142,705,657,23920,14283,38203
2/4/21,5925,6384,2441,1377,4498,2152,708,657,24142,14468,38610
2/5/21,5968,6523,2474,1394,4518,2170,715,657,24419,14620,39039
2/6/21,6027,6569,2509,1409,4523,2181,717,657,24592,14738,39330
2/7/21,6051,6584,2527,1417,4525,2182,718,682,24686,14804,39490
2/8/21,6068,6676,2534,1420,4551,2182,721,682,24834,14821,39655
2/9/21,6125,6751,2557,1427,4574,2195,724,688,25041,14932,39973
2/10/21,6180,6813,2591,1440,4585,2205,728,688,25230,15067,40297
2/11/21,6254,6887,2611,1456,4606,2220,733,688,25455,15206,40661
2/12/21,6306,7006,2646,1475,4625,2235,736,717,25746,15317,41063
2/13/21,6357,7057,2670,1480,4626,2244,742,731,25907,15413,41320
2/14/21,6381,7083,2681,1486,4626,2250,743,731,25981,15459,41440
2/15/21,6392,7098,2687,1487,4627,2250,744,731,26016,15468,41484
2/16/21,6393,7110,2690,1497,4637,2257,745,736,26065,15481,41546
2/17/21,6399,7166,2695,1497,4638,2262,749,736,26142,15508,41650
2/18/21,6408,7191,2707,1502,4658,2270,753,736,26225,15539,41764
2/19/21,6436,7252,2713,1506,4686,2281,756,765,26395,15605,42000
2/20/21,6486,7284,2731,1513,4695,2295,756,765,26525,15677,42202
2/21/21,6517,7300,2752,1524,4696,2301,758,765,26613,15708,42321
2/22/21,6526,7363,2763,1543,4728,2302,758,765,26748,15736,42484
2/23/21,6561,7407,2777,1561,4751,2310,759,765,26891,15837,42728
2/24/21,6622,7461,2812,1575,4776,2316,762,780,27104,15949,43053
2/25/21,6680,7520,2842,1593,4797,2322,762,780,27296,16054,43350
2/26/21,6731,7576,2873,1605,4803,2330,763,780,27461,16172,43633
2/27/21,6759,7591,2885,1613,4808,2338,763,780,27537,16235,43772
2/28/21,6803,7616,2894,1614,4808,2351,764,780,27630,16319,43949
3/1/21,6812,7679,2897,1624,4826,2354,765,780,27737,16341,44078
3/2/21,6854,7728,2931,1634,4843,2360,769,788,27907,16446,44353
3/3/21,6917,7775,2953,1646,4857,2366,770,788,28072,16555,44627
3/4/21,6995,7835,2982,1653,4877,2372,769,788,28271,16649,44920
3/5/21,7061,7900,3008,1669,4890,2385,769,788,28470,16725,45195
3/6/21,7098,7938,3032,1678,4893,2398,769,788,28594,16787,45381
3/7/21,7108,7942,3038,1680,4895,2407,769,788,28627,16819,45446
3/8/21,7112,8004,3041,1684,4916,2407,769,800,28733,16837,45570
3/9/21,7147,8035,3055,1695,4951,2412,769,800,28864,16890,45754
3/10/21,7201,8082,3071,1703,4955,2422,769,802,29005,16951,45956
3/11/21,7249,8115,3096,1716,4965,2433,769,802,29145,17023,46168
3/12/21,7299,8182,3112,1725,4966,2447,769,802,29302,17089,46391
3/13/21,7336,8201,3124,1729,4971,2463,770,802,29396,17136,46532
3/14/21,7358,8209,3130,1731,4971,2468,771,802,29440,17148,46588
3/15/21,7362,8281,3131,1732,4981,2471,771,802,29531,17163,46694
3/16/21,7386,8306,3140,1738,4995,2479,771,802,29617,17210,46827
3/17/21,7431,8333,3158,1749,5008,2490,773,802,29744,17256,47000
3/18/21,7471,8368,3173,1762,5022,2505,773,811,29885,17314,47199
3/19/21,7499,8419,3192,1770,5028,2515,773,811,30007,17358,47365
3/20/21,7524,8427,3210,1774,5029,2519,773,811,30067,17395,47462
3/21/21,7536,8434,3216,1777,5029,2520,773,811,30096,17411,47507
3/22/21,7554,8489,3218,1780,5040,2520,773,813,30187,17429,47616
3/23/21,7579,8505,3225,1780,5052,2520,773,813,30247,17454,47701
3/24/21,7627,8526,3247,1785,5060,2525,773,813,30356,17508,47864
3/25/21,7664,8547,3266,1791,5066,2528,774,813,30449,17544,47993
3/26/21,7695,8584,3275,1797,5073,2528,775,816,30543,17583,48126
3/27/21,7721,8593,3288,1800,5073,2534,776,816,30601,17611,48212
3/28/21,7733,8606,3299,1801,5073,2534,776,816,30638,17625,48263
3/29/21,7736,8627,3299,1805,5082,2534,776,818,30677,17632,48309
3/30/21,7759,8647,3304,1809,5089,2541,776,818,30743,17677,48420
3/31/21,7792,8673,3308,1812,5091,2544,777,819,30816,17724,48540
4/1/21,7824,8693,3319,1815,5098,2549,778,820,30896,17758,48654
4/2/21,7859,8705,3335,1817,5098,2553,779,820,30966,17789,48755
4/3/21,7882,8712,3349,1821,5098,2562,779,820,31023,17808,48831
4/4/21,7886,8713,3350,1821,5100,2565,779,820,31034,17817,48851
4/5/21,7886,8727,3350,1822,5108,2566,779,820,31058,17823,48881
4/6/21,7900,8748,3360,1823,5116,2568,779,820,31114,17854,48968
4/7/21,7924,8761,3366,1826,5125,2573,779,826,31180,17896,49076
4/8/21,7956,8774,3377,1830,5131,2584,779,826,31257,17917,49174
4/9/21,7987,8796,3389,1831,5140,2589,780,827,31339,17941,49280
4/10/21,8010,8801,3398,1834,5142,2598,780,827,31390,17955,49345
4/11/21,8012,8804,3398,1837,5143,2602,780,827,31403,17966,49369
4/12/21,8014,8810,3398,1845,5146,2602,780,829,31424,17969,49393
4/13/21,8031,8816,3403,1846,5152,2605,781,829,31463,17993,49456
4/14/21,8048,8830,3408,1852,5156,2605,781,829,31509,18015,49524
4/15/21,8071,8837,3413,1855,5161,2609,781,829,31556,18051,49607
4/16/21,8097,8846,3416,1857,5162,2617,781,829,31605,18071,49676
4/17/21,8114,8853,3422,1857,5163,2620,782,829,31640,18086,49726
4/18/21,8130,8858,3422,1858,5163,2622,782,829,31664,18095,49759
4/19/21,8135,8865,3422,1860,5167,2622,782,831,31684,18096,49780
4/20/21,8135,8868,3422,1860,5172,2622,782,831,31692,18097,49789
4/21/21,8177,8883,3437,1865,5176,2630,783,833,31784,18132,49916